####################
#..................#
....................
....................
....................
#..................#
#..................#
#..................#
....................
....................
....................
#..................#
#..................#
#..................#
....................
....................
....................
#..................#
#..................#
####################